5000000000000000000000000000600000000000000000000000000000000000000000
0111111111111111111111111111000000000000000000000000000000000000000000
0111111111111111111111111111000000000000000000000000000000000000000000
0111111111111111111111111111000000000000000000000000000000000000000000
0111111111111111111111111111000000000000000000000000000000000000000000
0111111111111111111111111111000000000000000000000000000000000000000000
0111111111111111111111111111000000000000000000000000000000000000000000
0111111111111111111111111111000000000000000000000000000000000000000000
0111111111111111111111111111000000000000000000000000000000000000000000
0111111111411111111111111111000000000000000000000000000000000000000000
0117111111011111111111111111000000000000000000000000000000000000000000
0111111114011111111111111111000000000000000000000000000000000000000000
0111111110011111111111111111000000000000000000000000000000000000000000
3000000040030000000000040111000000000000000000000000000000000000000000
0000000000000000000000000111000000000000000000000000000000000000000000
0000000000000000000000000111000000000000000000000000000000000000000000
0000000000000000000000000111000000000000000000000000000000000000000000
0000000000000000000000000111000000000000000000000000000000000000000000
5000000000000000000000000111000000000000000000000000000000000000000000
0111111111111111111111111111000000000000000000000000000000000000000000
0111111111111111111111111111000000000000000000000000000000000000000000
0111111111111111111111111111000000000000000000000000000000000000000000
0111111111111111111111111111000000000000000000000000000000000000000000
0111111111111111111111111111000000000000000000000000000000000000000000
0111111111111111111111111111000000000000000000000000000000000000000000
0111111111111111111111111111000000000000000000000000000000000000000000
0111111111111111111111111111000000000000000000000000000000000000000000
0111111111111111111111111111000000000000000000000000000000000000000000
0111111111111111111111111111000000000000000000000000000000000000000000
0111111111111111111111111111000000000000000000000000000000000000000000
0111111111111111111111111111000000000000000000000000000000000000000000
3011100011114111111111111111000000000000000000000000000000000000000000
0011100011110111111111111111000000000000000000000000000000000000000000
0011100011110111111111111111000000000000000000000000000000000000000000
0011100011110111111111111111000000000000000000000000000000000000000000
0011100011110111111111111111000000000000000000000000000000000000000000
0011100011100310004300004300400000000000000000000000000000000000000000
0011100011100000000000000000000000000000000000000000000000000000000000
0011100011100000000000000000000000000000000000000000000000000000000000
0011100011100000000000000000000000000000000000000000000000000000000000
0011100011100000000000000000000000000000500000000000000000001000600000
0011100011100000000000000000000000000000011111111111111111111111100000
0011100011100000000000000000000005000000011111111111111111111111100000
0011100011100000000000000000000000111111111111111111111111111111100000
0011100300040000000000000050000000111111111111111111111111111111100000
0011100000000000000000000001111111111111111111111111111111111111100000
0011100065000650006500000001111111111111111111111111111111110111100000
0011111111111111111111111111111111111111111111111111111001114111100000
0011111111111111111111111111111111111111000000000000000400000111100000
0011111111111111111111111111111111111111000000000000000000000111100000
0011111111111111111111111111111110000000400000000000000000000111100000
0011111111111111111111111111111110000000000000000000000500000111100000
0011111111111111111111111100000004000000000000000000000011111111100000
0011111111111111111111111100000000000000000000000000000011111111100000
0300000043000430000000000040000000000000000000000000000011111111100000
0000000000000000000000000000000000000000000000000000000300000000400000
