00000000000000000000000000000000000000000000000000000000000000
00000000000000000000000000000000000000000000000000000000000000
00000000000000000000000000000000000000000000000000000000000000
00000000000000000000000000000000000000000000000000000000000000
00000000000000000000000000000000000000000000000000000000000000
00000000000000000000000000000000000000000000000000000000000000
00000000000000000000000000000000000000000000000000000000000000
00000000000000000000000000000000000000000000000000000000000000
00000000000000000000000000000000000000000000000000000000000000
00000000000000000000000000000000000000000000000000000000000000
00000000000005555555555555555555555555555555555555000000000000
00000000000070000000000000000000000000000000000000800000000000
00000000000070000000000000000000000000000000000000800000000000
00000000000070000000000000000000000000000000000000800000000000
00000000000070000000000000000000000000000000000000800000000000
00000000000070000000000000000000000000000000000000800000000000
00000000000070000000000000000000000000000000000000800000000000
00000000000070000000000000000000000130000000000000800000000000
00000000000070000000000000000000000870000000000000800000000000
00000000000070000000000000000001300870013000000000800000000000
00000000000070000000000000000008700870087000000000800000000000
00000000000070000000000000013008700870087001300000800000000000
00000000000070000000000000087008700870087008700000800000000000
00000000000070000000000000087008700870087008700000800000000000
0000000000000300012222222220022002200220022002222220000000000
00000000000007000800000000000000000000000000000000000000000000
00000000000007000800000000000000000000000000000000000000000000
00000000000007000800000000000000000000000000000000000000000000
00000000000007000800000000000000000000000000000000000000000000
00000000000007000800000000000000000000000000000000000000000000
00000000000007000800000000000000000000000000000000000000000000
00000000000007000800000000000000000000000000000000000000000000
00000000000006000455555555555555555555555555500000000000000000
00000000000070000000000000000000000000000000000000800000000000
00000000000070000000000000000000000000000000000000800000000000
00000000000070000000000000000000000000000000000000800000000000
00000000000070000000000000000000000000000000000000800000000000
00000000000070000000000000000000000000000000000000800000000000
00000000000070000000000000000000000000000000122222000000000000
00000000000070000000000000000000000000000000800000000000000000
00000000000070000000000000000000000000000000800000000000000000
00000000000070000000000000000000000000000000800000000000000000
00000000000070000000000000000000000000000000800000000000000000
00000000000070000000000000000000000000000000800000000000000000
00000000000070000000000000000000000000000000800000000000000000
00000000000070000000000000000000000000000000800000000000000000
00000000000070000000000000000000000000000000800000000000000000
00000000000070000000000000000000000000000000800000000000000000
00000000000003000122222222222222222222222222000000000000000000
00000000000007000800000000000000000000000000000000000000000000
00000000000007000800000000000000000000000000000000000000000000
00000000000007000800000000000000000000000000000000000000000000
00000000000007000800000000000000000000000000000000000000000000
00000000000007000800000000000000000000000000000000000000000000
00000000000007000800000000000000000000000000000000000000000000
00000000000007000800000000000000000000000000000000000000000000
00000000000006000455555555000000000000000000000000000000000000
00000000000070000000000000800000000000000000000000000000000000
00000000000070000000000000800000000000000000000000000000000000
00000000000070000000000000800000000000000000000000000000000000
00000000000070000000000900800000000000000000000000000000000000
00000000000070000000000000800000000000000000000000000000000000
00000000000002222222222222000000000000000000000000000000000000
00000000000000000000000000000000000000000000000000000000000000
