0555555555555555555555555555000000000000000000000000000000000000000000
7000000000000000000000000000800000000000000000000000000000000000000000
7000000000000000000000000000800000000000000000000000000000000000000000
7000000000000000000000000000800000000000000000000000000000000000000000
7000000000000000000000000000800000000000000000000000000000000000000000
7000000000000000000000000000800000000000000000000000000000000000000000
7000000000000000000000000000800000000000000000000000000000000000000000
7000000000130000000000013000800000000000000000000000000000000000000000
7000000000870000000000087000800000000000000000000000000000000000000000
7000000001070000000000087000800000000000000000000000000000000000000000
7000000008070000000000087000800000000000000000000000000000000000000000
7000000010070000000000087000800000000000000000000000000000000000000000
7000000080070000000000087000800000000000000000000000000000000000000000
0222222200002222222222207000800000000000000000000000000000000000000000
0000000000000000000000007000800000000000000000000000000000000000000000
0000000000000000000000007000800000000000000000000000000000000000000000
0000000000000000000000007000800000000000000000000000000000000000000000
0000000000000000000000007000800000000000000000000000000000000000000000
0555555555555555555555556000800000000000000000000000000000000000000000
7000000000000000000000000000800000000000000000000000000000000000000000
7000000000000000000000000000800000000000000000000000000000000000000000
7000000000000000000000000000800000000000000000000000000000000000000000
7000000000000000000000000000800000000000000000000000000000000000000000
7000000000000000000000001300800000000000000000000000000000000000000000
7000000000000000000000008700800000000000000000000000000000000000000000
7000000000000000000000008700800000000000000000000000000000000000000000
7000000000000000001300008700800000000000000000000000000000000000000000
7000000000000000008700008700800000000000000000000000000000000000000000
7000000000000000008700008700800000000000000000000000000000000000000000
7000000000001300008700008700800000000000000000000000000000000000000000
7000000000008700008700008700800000000000000000000000000000000000000000
0300012300010700008700008700800000000000000000000000000000000000000000
0700080700080700008700008700800000000000000000000000000000000000000000
0700080700080700008700008700800000000000000000000000000000000000000000
0700080700080700008700008700800000000000000000000000000000000000000000
0700080700080700008700008700800000000000000000000000000000000000000000
0700080700080022220022220022000000000000000000000000000000000000000000
0700080700080000000000000000000000000000000000000000000000000000000000
0700080700080000000000000000000000000000000000000000000000000000000000
0700080700080000000000000000000000000000000000000000000000000000000000
0700080700080000000000000000000000000000055555555555555555555555000000
0700080700080000000000000000000000000000700000000000000000000000800000
0700080700080000000000000000000000555555600000000000000000000000800000
0700080700080000000000000000000007000000000000000000000000000000800000
0700080022200000000000000005555556000000000000000000000000000000800000
0700080000000000000000000070000000000000000000000000000000000000800000
0700045500555005550055555560000000000000000000000000000000001300800000
0700000087000870008700000000000000000000000000000000000122220700800000
0700000046000870008700000000000000000000122222222222222000000700800000
0700000000000460008700000000000000000000800000000000000000000700800000
0700000000000000004600000000000001222222000000000000000000000700800000
0700000000000000000000000000000008000000000000000000000055555600800000
0700000013000000000000000012222220000000000000000000000700000000800000
0700000087000130000000000080000000000000000000000000000709000000800000
0022222200222002222222222200000000000000000000000000000700000000800000
0000000000000000000000000000000000000000000000000000000022222222000000
