00000000000000000000000000000000000000000000000000000000000000
00000000000000000000000000000000000000000000000000000000000000
00000000000000000000000000000000000000000000000000000000000000
00000000000000000000000000000000000000000000000000000000000000
00000000000000000000000000000000000000000000000000000000000000
00000000000000000000000000000000000000000000000000000000000000
00000000000000000000000000000000000000000000000000000000000000
00000000000000000000000000000000000000000000000000000000000000
00000000000000000000000000000000000000000000000000000000000000
00000000000000000000000000000000000000000000000000000000000000
00000000000050000000000000000000000000000000000000600000000000
00000000000011111111111111111111111111111111111111000000000000
00000000000011111111111111111111111111111111111111000000000000
00000000000011111111111111111111111111111111111111000000000000
00000000000011111111111111111111111111111111111111000000000000
00000000000011111111111111111111111111111111111111000000000000
00000000000011111111111111111111111111111111111111000000000000
00000000000011111111111111111111111111111111111111000000000000
00000000000011111111111111111111111111111111111111000000000000
00000000000011111111111111111111111111111111111111000000000000
00000000000011111111111111111111111111111111111111000000000000
00000000000011111111111111111111111111111111111711000000000000
00000000000011111111111111111111111111111111111111000000000000
000000000000111111111ll111111111111111111111111111000000000000
00000000000031111140000000043004300430043004300000400000000000
00000000000001111100000000000000000000000000000000000000000000
00000000000001111100000000000000000000000000000000000000000000
00000000000001111100000000000000000000000000000000000000000000
00000000000001111100000000000000000000000000000000000000000000
00000000000001111100000000000000000000000000000000000000000000
00000000000001111100000000000000000000000000000000000000000000
00000000000001111100000000000000000000000000000000000000000000
00000000000051111111111111111111111111111111111111600000000000
00000000000001111111111111111111111111111111111111000000000000
00000000000001111111111111111111111111111111111111000000000000
00000000000001111111111111111111111111111111111111000000000000
00000000000001111111111111111111111111111111111111000000000000
00000000000001111111111111111111111111111111111111000000000000
00000000000001111111111111111111111111111111111111400000000000
00000000000001111111111111111111111111111111000000000000000000
00000000000001111111111111111111111111111111000000000000000000
00000000000001111111111111111111111111111111000000000000000000
00000000000001111111111111111111111111111111000000000000000000
00000000000001111111111111111111111111111111000000000000000000
00000000000001111111111111111111111111111111000000000000000000
00000000000001111111111111111111111111111111000000000000000000
00000000000001111111111111111111111111111111000000000000000000
00000000000001111111111111111111111111111111000000000000000000
00000000000031111111111111111111111111111111400000000000000000
00000000000001111100000000000000000000000000000000000000000000
00000000000001111100000000000000000000000000000000000000000000
00000000000001111100000000000000000000000000000000000000000000
00000000000001111100000000000000000000000000000000000000000000
00000000000001111100000000000000000000000000000000000000000000
00000000000001111100000000000000000000000000000000000000000000
00000000000001111100000000000000000000000000000000000000000000
00000000000051111111111111600000000000000000000000000000000000
00000000000001111111111111000000000000000000000000000000000000
00000000000001111111111111000000000000000000000000000000000000
00000000000001111111111111000000000000000000000000000000000000
00000000000001111111111111000000000000000000000000000000000000
00000000000001111111111111000000000000000000000000000000000000
00000000000031111111111111400000000000000000000000000000000000
00000000000000000000000000000000000000000000000000000000000000
