000000000000000000000000000000000000000000000000000000000000000
000000000000000000000000000000000000000000000000000000000000000
000000000000000000000000000000000000000000000000000000000000000
000000000000000000000000000000000000000000000000000000000000000
000000000000000000000000000000000000000000000000000000000000000
000000000000000000000000000000000000000000000000000000000000000
000000000000000000000000000000000000000000000000000000000000000
000000000000000000000000000000000000000000000000000000000000000
000000000000000000000000000000000000000555000000000000000000000
000000000000000000555500000000000000056000450000000000000000000
000000000000005556000045555555555555600000004555555000000000000
000000000005560000000000000000000000000000000000000800000000000
000000000070000000000000000000000000000000000000000800000000000
000000000070000000000000000000000000000000000000000800000000000
000000000070000000000000000000000000000000000000900800000000000
000000000070000000000000000000000000000000000000000800000000000
000000000070000000001230000000000000000000122222222000000000000
000000000070000000008070000000000000000000800000000000000000000
000000000070000000010070000000000000000000800000000000000000000
000000000070000000080070000001300000000000800000000000000000000
000000000070000000100070000008700000000000800000000000000000000
000000000070000000800070000008700000000000800000000000000000000
000000000002222222000002222220022222222222000000000000000000000
000000000000000000000000000000000000000000000000000000000000000
000000000000000000000000000000000000000000000000000000000000000
000000000000000000000000000000000000000000000000000000000000000
000000000000000000000000000000000000000000000000000000000000000
000000000000000000000000000000000000000000000000000000000000000
000000000000000000000000000000000000000000000000000000000000000
000000000000000000000000000000000000000000000000000000000000000
000000000000000000000000000000000000000000000000000000000000000
000000000000000000000000000000000000000000000000000000000000000
