000000000000000000000000000000000000000000000000000000000000000
000000000000000000000000000000000000000000000000000000000000000
000000000000000000000000000000000000000000000000000000000000000
000000000000000000000000000000000000000000000000000000000000000
000000000000000000000000000000000000000000000000000000000000000
000000000000000000000000000000000000000000000000000000000000000
000000000000000000000000000000000000000000000000000000000000000
000000000000000000000000000000000000000000000000000000000000000
000000000000000000000000000000000000005111600000000000000000000
000000000000000005111160000000000000511111116000000000000000000
000000000000051111111111111111111111111111111111111600000000000
000000000051111111111111111111111111111111111111111100000000000
000000000011111111111111111111111111111111111111111100000000000
000000000011111111111111111111111111111111111111111100000000000
000000000011111111111111111111111111111111111111111100000000000
000000000011111111111111111111111111111111111111111100000000000
000000000011111111111111111111111111111111111111111400000000000
000000000011111111111011111111111111111111100000000000000000000
000000000011111111114011111111111111111111100000000000000000000
000000000011111111110011111111111111111111100000000000000000000
000000000011171111140011111111111111111111100000000000000000000
000000000011111111100011111111111111111111100000000000000000000
000000000031111111400031111114311111111111400000000000000000000
000000000000000000000000000000000000000000000000000000000000000
000000000000000000000000000000000000000000000000000000000000000
000000000000000000000000000000000000000000000000000000000000000
000000000000000000000000000000000000000000000000000000000000000
000000000000000000000000000000000000000000000000000000000000000
000000000000000000000000000000000000000000000000000000000000000
000000000000000000000000000000000000000000000000000000000000000
000000000000000000000000000000000000000000000000000000000000000
000000000000000000000000000000000000000000000000000000000000000
