00000000000000000000000000000000000000000000000000000000000000
00000000000000000000000000000000000000000000000000000000000000
00000000000000000000000000000000000000000000000000000000000000
00000000000000000000000000000000000000000000000000000000000000
00000000000000000000000000000000000000000000000000000000000000
00000000000000000000000000000000000000000000000000000000000000
00000000000000000000000000000000000000000000000000000000000000
00000000000000000000000000000000000000000000000000000000000000
00000000000000000000000000000000000000000000000000000000000000
00000000000000000000000000000000000000000000000000000000000000
00000000000050000000000000000000000000000000000000600000000000
0000000000001111111111111111111111111111111111111l000000000000
0000000000001111111111111111111111111111111111111l000000000000
0000000000001111111111111111111111111111111111111l000000000000
0000000000001111111111111111111111111111111111111l000000000000
0000000000001111111111111111111111111111111111111l000000000000
0000000000001111111111111111111111111111111111111l000000000000
0000000000001111111111111111111111111111111111111l000000000000
0000000000001111111111111111111111111111111111111l000000000000
0000000000001111111111111111111111111111111111111l000000000000
0000000000001111111111111111111111111111111111111l000000000000
0000000000001171111111111111111111111111111111111l000000000000
0000000000001111111111111111111111111111111111111l000000000000
000000000000111111111ll11111111111111111111111111l000000000000
00000000000030000000000000043004300430043004311111400000000000
00000000000000000000000000000000000000000000011111000000000000
00000000000000000000000000000000000000000000011111000000000000
00000000000000000000000000000000000000000000011111000000000000
00000000000000000000000000000000000000000000011111000000000000
00000000000000000000000000000000000000000000011111000000000000
00000000000000000000000000000000000000000000011111000000000000
00000000000000000000000000000000000000000000011111000000000000
00000000000051111111111111111111111111111111111111600000000000
00000000000001111111111111111111111111111111111111000000000000
00000000000001111111111111111111111111111111111111000000000000
00000000000001111111111111111111111111111111111111000000000000
00000000000001111111111111111111111111111111111111000000000000
00000000000001111111111111111111111111111111111111000000000000
00000000000001111111111111111111111111111111111111400000000000
00000000000001111111111111111111111111111111000000000000000000
00000000000001111111111111111111111111111111000000000000000000
00000000000001111111111111111111111111111111000000000000000000
00000000000001111111111111111111111111111111000000000000000000
00000000000001111111111111111111111111111111000000000000000000
00000000000001111111111111111111111111111111000000000000000000
00000000000001111111111111111111111111111111000000000000000000
00000000000001111111111111111111111111111111000000000000000000
00000000000001111111111111111111111111111111000000000000000000
00000000000031111111111111111111111111111111400000000000000000
00000000000001111100000000000000000000000000000000000000000000
00000000000001111100000000000000000000000000000000000000000000
00000000000001111100000000000000000000000000000000000000000000
00000000000001111100000000000000000000000000000000000000000000
00000000000001111100000000000000000000000000000000000000000000
00000000000001111100000000000000000000000000000000000000000000
00000000000001111100000000000000000000000000000000000000000000
00000000000051111111111111600000000000000000000000000000000000
00000000000001111111111111000000000000000000000000000000000000
00000000000001111111111111000000000000000000000000000000000000
00000000000001111111111111000000000000000000000000000000000000
00000000000001111111111111000000000000000000000000000000000000
00000000000001111111111111000000000000000000000000000000000000
00000000000031111111111111400000000000000000000000000000000000
00000000000000000000000000000000000000000000000000000000000000
