0555555555555555555555555555555555555500555550000550
7000000000000000000000000000000000000087000008007008
7000000000000000000000000000000000000087000008007008
7000000000000000000000000000000000000087000004556008
7000000000122230000000000000000000000087000000000008
7000000000800070000000000000000000000087000000000008
7000000000800070000000000000000000000046000000000008
7000000000800070000000000000000000000000000001223008
7000000000800070000000000000000000000000000008007008
0222222222000002222222222300000000001222222220007008
0000000000000000000000000022222222220000000000007008
0000000000000000000000000000000000000000000000007008
0000000000000000000000000000000000000000000000007008
0000000000000000000000000000000000000000000000007008
0000000000000000000000000000000000000000000000007008
0000000000000000000000000000000000000000000000007008
0000000000000000000055555555555555005555555555556008
0000000000000000000700000000000000870000000000000008
0000000000000000000700000000000000870000000000000008
0000000000000000000700000000000000870000000000000008
0000000000000000000700000000000000870000000000000008
0000000000000000000700000000000000870000000000000008
0000000000000000000700000000000000460000000000000008
0000000000000000000700000000000000000000000000000008
0000000000000000000700000000000000000013000000000008
0000000000000000000700000000001222222200222222222220
0000000000000000000700012222220000000000000000000000
0000000000000000000700080000000000000000000000000000
0000000000000000000700080000000000000000000000000000
0000000000000000000700080000000000000000000000000000
0000000000000000000700080000000000000000000000000000
0000000000000000000700080000000000000000000000000000
0000000000000000000700080000000000000000000000000000
0000000000000000000700080000000000000000000000000000
0000000000000000000700045555500000000000000000000000
0000000000000000000700000000080000000000000000000000
0000000000000000000700000000080000000000000000000000
0000000000000000000700000009080000000000000000000000
0000000000000000000700000000080000000000000000000000
0000000000000000000700012222200000000000000000000000
0000000000000000000700080000000000000000000000000000
0000000000000000000700080000000000000000000000000000
0000000000000000000700080000000000000000000000000000
0000000000000000000022200000000000000000000000000000
