5111111111111111111111111111111111111165111116005116
1111111111111111111111111111111111111111111111001111
1111111111111111111111111111111111111111111111001111
1111111111111111111111111111111111111111111111111111
1111111111111111111111111111111111111111111111111111
1111111111100011111111111111111111111111111111111111
1111111111100011111111111111111111111111111111111111
1117111111100011111111111111111111111111111111111111
1111111111100011111111111111111111111111111111001111
3111111111400031111111111111111111111111111114001111
0000000000000000000000000311111111114000000000001111
0000000000000000000000000000000000000000000000001111
0000000000000000000000000000000000000000000000001111
0000000000000000000000000000000000000000000000001111
0000000000000000000000000000000000000000000000001111
0000000000000000000000000000000000000000000000001111
0000000000000000000511111111111000651111111111111111
0000000000000000000111111111111111011111111111111111
0000000000000000000111111111111111011111111111111111
0000000000000000000111111111111111011111111111111111
0000000000000000000111111111111111011111111111111111
0000000000000000000111111111111111111111111111111111
0000000000000000000111111111111111111111111111111111
0000000000000000000111111111111111111111111111111111
0000000000000000000111111111111111111111111111111111
0000000000000000000111111111111111111143111111111114
0000000000000000000111111111114000000000000000000000
0000000000000000000111110000000000000000000000000000
0000000000000000000111110000000000000000000000000000
0000000000000000000111110000000000000000000000000000
0000000000000000000111110000000000000000000000000000
0000000000000000000111110000000000000000000000000000
0000000000000000000111110000000000000000000000000000
0000000000000000000111110000000000000000000000000000
0000000000000000000111111111160000000000000000000000
0000000000000000000111111111110000000000000000000000
0000000000000000000111111111110000000000000000000000
0000000000000000000111111111110000000000000000000000
0000000000000000000111111111110000000000000000000000
0000000000000000000111110000040000000000000000000000
0000000000000000000111110000000000000000000000000000
0000000000000000000111110000000000000000000000000000
0000000000000000000111110000000000000000000000000000
0000000000000000000311140000000000000000000000000000
